20 20
3 8 2
4 4 4 4 4 4 4 4 4 4 4 4 4 4 4 4 4 4 4 4
4 4 4 4 4 4 4 4 4 4 4 4 4 4 4 4 4 4 4 4
4 4 4 4 4 4 4 4 4 4 4 4 4 4 4 4 4 4 4 4
4 4 4 4 4 4 4 4 4 4 4 4 4 4 4 4 4 4 4 4
4 4 4 4 4 4 4 4 4 4 4 4 4 4 4 4 4 4 4 4
4 4 4 4 1 103 1 103 1 103 1 103 1 103 1 103 4 4 4 4
4 4 4 4 0 1 0 1 0 1 0 1 0 1 0 1 4 4 4 4
4 4 4 4 1 0 1 0 1 0 1 0 1 0 1 0 4 4 4 4
4 2 2 2 0 1 10 1 0 1 0 1 0 1 0 1 3 3 3 4
4 2 5 2 1 0 1 0 1 0 1 0 1 0 1 0 3 3 3 4
4 2 2 2 0 1 10 1 0 1 0 1 0 1 0 1 3 3 3 4
4 4 4 4 1 0 1 0 1 0 1 0 1 0 1 0 4 4 4 4
4 4 4 4 0 1 0 1 0 1 0 1 0 1 0 1 4 4 4 4
4 4 4 4 111 0 111 0 111 0 111 0 111 0 111 0 4 4 4 4
4 4 4 4 4 4 4 4 4 4 4 4 4 4 4 4 4 4 4 4
4 4 4 4 4 4 4 4 4 4 4 4 4 4 4 4 4 4 4 4
4 4 4 4 4 4 4 4 4 4 4 4 4 4 4 4 4 4 4 4
4 4 4 4 4 4 4 4 4 4 4 4 4 4 4 4 4 4 4 4
4 4 4 4 4 4 4 4 4 4 4 4 4 4 4 4 4 4 4 4
4 4 4 4 4 4 4 4 4 4 4 4 4 4 4 4 4 4 4 4